00000000000000000000
00000000000000000000
00000000000000000000
00000000000000000000
00000000000000000000
00000000111000000000
00000000141000000000
00000111131000000000
00000143251110000000
00000111223410000000
00000001311110000000
00000001410000000000
00000001110000000000
00000000000000000000
00000000000000000000
00000000000000000000
00000000000000000000
00000000000000000000
00000000000000000000
00000000000000000000