00000000000000000000
00000000000000000000
00000000000000000000
00000000000000000000
00000000000000000000
00000000111000000000
00000000141000000000
00000111131000000000
00000122251110000000
00000113222210000000
00000001211110000000
00000001410000000000
00000001110000000000
00000000000000000000
00000000000000000000
00000000000000000000
00000000000000000000
00000000000000000000
00000000000000000000
00000000000000000000